     ___       __       __           _______   ______   .______    __       __  .__   __.      _______.
    /   \     |  |     |  |         /  _____| /  __  \  |   _  \  |  |     |  | |  \ |  |     /       |
   /  ^  \    |  |     |  |        |  |  __  |  |  |  | |  |_)  | |  |     |  | |   \|  |    |   (----`
  /  /_\  \   |  |     |  |        |  | |_ | |  |  |  | |   _  <  |  |     |  | |  . `  |     \   \    
 /  _____  \  |  `----.|  `----.   |  |__| | |  `--'  | |  |_)  | |  `----.|  | |  |\   | .----)   |   
/__/     \__\ |_______||_______|    \______|  \______/  |______/  |_______||__| |__| \__| |_______/    
                                                                                                       