                                 (`-.                                        
                                  \  `                                       
     /)         ,   '--.           \    `                                    
    //     , '          \/          \   `   `                                
   //    ,'              ./         /\    \>- `   ,----------.               
  ( \  ,'    .-.-._        /      ,' /\    \   . `            `.             
   \ \'     /.--. .)       ./   ,'  /  \     .      `           `.           
    \     -{/    \ .)        / /   / ,' \       `     `-----.     \          
    <\      )     ).:)       ./   /,' ,' \        `.  /\)    `.    \         
     >^,  //     /..:)       /   //--'    \         `(         )    )        
      | ,'/     /. .:)      /   (/         \          \       /    /         
      ( |(_    (...::)     (                \       .-.\     /   ,'          
      (O| /     \:.::)                      /\    ,'   \)   /  ,'            
       \|/      /`.:::)                   ,/  \  /         (  /              
               /  /`,.:)                ,'/    )/           \ \              
             ,' ,'.'  `:>-._._________,<;'    (/            (,'              
           ,'  /  |     `^-^--^--^-^-^-'                                     
 .--------'   /   |                                                          
(       .----'    |                                                          
 \ <`.  \         |                                                          
  \ \ `. \        |                                      
   \ \  `.`.      |                                                          
    \ \   `.`.    |                                                          
     \ \    `.`.  |                                                          
      \ \     `.`.|                                                          
       \ \      `.`.                                                         
        \ \     ,^-'                                                         
         \ \    |                                                            
          `.`.  |                                                            
             .`.|                                                            
              `._>