.___  ___.  _______   _______      ___          _______   __    __  .__   __.   _______  _______   ______   .__   __. 
|   \/   | |   ____| /  _____|    /   \        |       \ |  |  |  | |  \ |  |  /  _____||   ____| /  __  \  |  \ |  | 
|  \  /  | |  |__   |  |  __     /  ^  \       |  .--.  ||  |  |  | |   \|  | |  |  __  |  |__   |  |  |  | |   \|  | 
|  |\/|  | |   __|  |  | |_ |   /  /_\  \      |  |  |  ||  |  |  | |  . `  | |  | |_ | |   __|  |  |  |  | |  . `  | 
|  |  |  | |  |____ |  |__| |  /  _____  \     |  '--'  ||  `--'  | |  |\   | |  |__| | |  |____ |  `--'  | |  |\   | 
|__|  |__| |_______| \______| /__/     \__\    |_______/  \______/  |__| \__|  \______| |_______| \______/  |__| \__| 
                                                                                                                     