.__   __.  __    __   __  ___  _______ .___  ___.      ______   .___  ___.  _______   _______      ___      
|  \ |  | |  |  |  | |  |/  / |   ____||   \/   |     /  __  \  |   \/   | |   ____| /  _____|    /   \     
|   \|  | |  |  |  | |  '  /  |  |__   |  \  /  |    |  |  |  | |  \  /  | |  |__   |  |  __     /  ^  \    
|  . `  | |  |  |  | |    <   |   __|  |  |\/|  |    |  |  |  | |  |\/|  | |   __|  |  | |_ |   /  /_\  \   
|  |\   | |  `--'  | |  .  \  |  |____ |  |  |  |    |  `--'  | |  |  |  | |  |____ |  |__| |  /  _____  \  
|__| \__|  \______/  |__|\__\ |_______||__|  |__|     \______/  |__|  |__| |_______| \______| /__/     \__\