____    ____  ______    __    __         _______   __   _______  _______      
\   \  /   / /  __  \  |  |  |  |       |       \ |  | |   ____||       \     
 \   \/   / |  |  |  | |  |  |  |       |  .--.  ||  | |  |__   |  .--.  |    
  \_    _/  |  |  |  | |  |  |  |       |  |  |  ||  | |   __|  |  |  |  |    
    |  |    |  `--'  | |  `--'  |       |  '--'  ||  | |  |____ |  '--'  | __ 
    |__|     \______/   \______/        |_______/ |__| |_______||_______/ (__)
                                                                              