     _______. __          ___       __  .__   __. 
    /       ||  |        /   \     |  | |  \ |  | 
   |   (----`|  |       /  ^  \    |  | |   \|  | 
    \   \    |  |      /  /_\  \   |  | |  . `  | 
.----)   |   |  `----./  _____  \  |  | |  |\   | 
|_______/    |_______/__/     \__\ |__| |__| \__|