.___________. __    __   _______     _______  .______          ___       _______   ______   .__   __.  __  
|           ||  |  |  | |   ____|   |       \ |   _  \        /   \     /  _____| /  __  \  |  \ |  | |  | 
`---|  |----`|  |__|  | |  |__      |  .--.  ||  |_)  |      /  ^  \   |  |  __  |  |  |  | |   \|  | |  | 
    |  |     |   __   | |   __|     |  |  |  ||      /      /  /_\  \  |  | |_ | |  |  |  | |  . `  | |  | 
    |  |     |  |  |  | |  |____    |  '--'  ||  |\  \----./  _____  \ |  |__| | |  `--'  | |  |\   | |__| 
    |__|     |__|  |__| |_______|   |_______/ | _| `._____/__/     \__\ \______|  \______/  |__| \__| (__)  