____    ____  ______    __    __      __  ___  __   __       __       _______  _______  
\   \  /   / /  __  \  |  |  |  |    |  |/  / |  | |  |     |  |     |   ____||       \ 
 \   \/   / |  |  |  | |  |  |  |    |  '  /  |  | |  |     |  |     |  |__   |  .--.  |
  \_    _/  |  |  |  | |  |  |  |    |    <   |  | |  |     |  |     |   __|  |  |  |  |
    |  |    |  `--'  | |  `--'  |    |  .  \  |  | |  `----.|  `----.|  |____ |  '--'  |
    |__|     \______/   \______/     |__|\__\ |__| |_______||_______||_______||_______/ 